113 8 10
1111111111111111111111111111111111111111111111111111111111111111111111111111111111111111111111111111111111111111
1190011111100000000001110000000001100000000011100000000000000000011100000011000000110000000000000001100000000011
1100011111100000000001110000000000000000000011000000000000000000001100000011000000110000000000000001100000000011
1100011111100011000001110000000008000000000011000000000000000000001100110011001100110011000000000001100000000011
1100011111100011000001110011110011110011110011000000000080000000001100110011001100110011000000011001100110000011
1100000000000011000700000011000001100000110000000000000000000000000000110080001100800011000011611008000116110011
1100000008000011060000000011006000006000110000000006006000600060000000110000001100000011000011111080080111110088
1111111111111111111111111111111111111111111111111111111111111111111111111111111111111111111111111111111111111111