11111111111111111111111111111111
11900111111000000000011100000000
11000111111000000000011100000000
11000111111000110000011100000000
11000111111000110000011100111100
11000000000000110600000000110060
11000000080000110000000000110000
11111111111111111111111111111111