36 21 1000
11111111111111111111111111111111111
19000000000000000000000000000000001
10000000000000000000000000000000001
10000100111111110011111001111100001
10000100100000010010000001000000001
10000100100000010010000001000000001
10000100100000010011111001111100001
10000100100000010000001001000000001
10000100111111110011111001111100001
10000000000000000000000000000000001
10000000000000000000000000000000001
10000000000000000000000000000000001
10000000000000000000000000000000001
10000000000000000000000000000000001
10000000000000000000000000000000001
10000000000000000000000000000000001
10000000000000000000000000000000001
10000000000000000000000000000000001
10000000000000000000000000000000001
10000000000000000000000000000000001
11111111111111111111111111111111111