50 11
1111111111111111111111111111111111111111111111111
1500000000000000000000000000000000000000000000041
1000000000000000000000000000000000000000000000001
1000000000000000000000000000000000000000000000001
1000000000000000000000000000000000000000000000001
1000000000000000000000000000000000000000000000001
1000000000000000000000000000000000000000000000001
1000000000000000070000000000000000000000000000001
1000600900000006000000000000000000000000000000001
1300000008020000000000000000000000000000000000021
1111111111111111111111111111111111111111111111111