50 16 4
1111111111111111111111111111111111111111111111111
1500000000000000000000000000000000000000000000041
1000000000000000000000000000000000000000000000001
1000000000000000000000000000000000000000000000001
1000000000000000000000000000000000000000000000001
1000000000000000000020000000000000000000000000001
1000000000000000000200000000000000000000000000001
1000000000000000002000000000000000000000000000001
1000000000900000020000000000000000000000000000001
1000000000111100200000000000000000000000000000001
1000000001000002000000000000000000000000080070001
1000000010000020000000011000080000000000213000001
1000000100000210007000041000000000080000111000001
1000601000002110000000000000040000300000111000021
1300010008000000000000000001111111111111111111111
1111111111111111111111111111111111111111111111111