50 16 4
1111111111111111111111111111111111111111111111111
1500000000000000000000000000000000000000000000041
1000000000000000000000000000000000000000000000001
1000000000000000000000000000000000000000000000001
1000000000000000000000000000000000000000000000001
1000000000000000000023000000000000000000000000001
1000000000000000000200300000000000000000000000001
1000000000000000002000030000000000000000000000001
1000000000900000020000003000000000000000000000001
1000000000111100200000000300000000000000000000001
1000000001000002000000000030000000000000080070001
1000000010000020000000011003080000000000213000001
1000000100000210000000041000300000080000111000001
1000601000002110000000000000040000300060111000021
1300010008000000000000000001111111111111111111111
1111111111111111111111111111111111111111111111111