50 16
1111111111111111111111111111111111111111111111111
1500000000000000000000000000000000000000000000041
1000000000000000000000000000000000000000000000001
1000000000000000000000000000000000000000000000001
1000000000000000000000000000000000000000000000001
1000000000000000000020000500000000000000000000001
1000000000000000000200005000000000000000000000001
1000000000000000002000050000000000000000000000001
1000000000000000020000500000000000000000000000001
1000000000000000200005000000000000000000000000001
1000000000000002000050000000000000000000000000001
1000000000000020000500011000000000000000213000001
1000000000000210115000041000000000000000111000001
1000600900002110000000000000040000300000111000021
1300000008000000000000000001111111111111111111111
1111111111111111111111111111111111111111111111111